1111111111111
10010000E00C1
10P0011111001
1C001100C00B1
1111111111111
