NO ./assets/config/minecraft/oak_planks.xpm
SO ./assets/config/minecraft/grass_block_side.xpm
WE ./assets/config/minecraft/grass_block_snow.xpm
EA ./assets/config/minecraft/purpur_block.xpm

F 46,204,113
C 248,196,113

                 1111111111111
                 1000000000001
                 1111111111101
111111111111111111000000000001
1S1000001000000011010111111111
101000001100100110010000001
101000011000000011111111101
101000001100000111111000001
101000001000000011111011111
101110111100000111111011111
100000000000000000000000001
100000000000000000000000001
100000000000000000000000001
100000000000000000000000001
111101111111110111111111111
100000001000000000001
100000001000000000001
110101011000000000001
111111111111111111111
