1111111111111
1E01000000001
1000011111001
1P0011000C001
1111111111111
