111111
1CB111
10E0111
1P0011
111111
