1111111111111
1001000000001
1000011111001
1000110E0C001
1111111111111
