11111
1C011
10E01
1P001
11111
